100000000000000000000100000000000000000000
000000000000000000000000000000000000000000
000000000000000000000000000000000000000000
000000000010000000000000000000010000000000
000000000111000000000000000000111000000000
000000000000011000000000000000000011000000
000000011110010000000000000011110010000000
000000111000000000000000000111000000000000
000000001111100000000000000001111100000000
000000000111100000000000000000111100000000
000000000000000000000000000000000000000000
000000000000000000000000000000000000000000
000000000000000000000000000000000000000000
000000010000000000000000000010000000000000
000000010000000000000000000010000000000000
000000011000000000000000000011000000000000
000000000000000000000000000000000000000000
000000000000000000000000000000000000000000
000000000000000000000000000000000000000000
000000000000000000000000000000000000000000
000000000000000000000000000000000000000000
000000000000000000001000000000000000000001
100000000000000000000100000000000000000000
000000000000000000000000000000000000000000
000000000000000000000000000000000000000000
000000000010000000000000000000010000000000
000000000111000000000000000000111000000000
000000000000011000000000000000000011000000
000000011110010000000000000011110010000000
000000111000000000000000000111000000000000
000000001111100000000000000001111100000000
000000000111100000000000000000111100000000
000000000000000000000000000000000000000000
000000000000000000000000000000000000000000
000000000000000000000000000000000000000000
000000010000000000000000000010000000000000
000000010000000000000000000010000000000000
000000011000000000000000000011000000000000
000000000000000000000000000000000000000000
000000000000000000000000000000000000000000
000000000000000000000000000000000000000000
000000000000000000000000000000000000000000
000000000000000000000000000000000000000000
000000000000000000001000000000000000000001
100000000000000000000100000000000000000000
000000000000000000000000000000000000000000
000000000000000000000000000000000000000000
000000000010000000000000000000010000000000
000000000111000000000000000000111000000000
000000000000011000000000000000000011000000
000000011110010000000000000011110010000000
000000111000000000000000000111000000000000
000000001111100000000000000001111100000000
000000000111100000000000000000111100000000
000000000000000000000000000000000000000000
000000000000000000000000000000000000000000
000000000000000000000000000000000000000000
000000010000000000000000000010000000000000
000000010000000000000000000010000000000000
000000011000000000000000000011000000000000
000000000000000000000000000000000000000000
000000000000000000000000000000000000000000
000000000000000000000000000000000000000000
000000000000000000000000000000000000000000
000000000000000000000000000000000000000000
000000000000000000001000000000000000000001
100000000000000000000100000000000000000000
000000000000000000000000000000000000000000
000000000000000000000000000000000000000000
000000000010000000000000000000010000000000
000000000111000000000000000000111000000000
000000000000011000000000000000000011000000
000000011110010000000000000011110010000000
000000111000000000000000000111000000000000
000000001111100000000000000001111100000000
000000000111100000000000000000111100000000
000000000000000000000000000000000000000000
000000000000000000000000000000000000000000
000000000000000000000000000000000000000000
000000010000000000000000000010000000000000
000000010000000000000000000010000000000000
000000011000000000000000000011000000000000
000000000000000000000000000000000000000000
000000000000000000000000000000000000000000
000000000000000000000000000000000000000000
000000000000000000000000000000000000000000
000000000000000000000000000000000000000000
000000000000000000001000000000000000000001